f . . . . . . . . . . . . . . . . . . . . . . . . . . . . . . .
. c 4 4 4 4 4 4 6 4 4 4 4 4 4 4 4 4 4 4 4 4 4 4 4 4 4 4 4 4 6 . 
f 8 . . . . . . 2 . . . . . . . . . . . . . . . g . . . . . 2 . 
. 8 . . . . . . 2 . . . . . . . . . . . . . . . . . . . . . 2 . 
f 8 . . . . . . 2 . . . . . . . . . . . . . . . g . . . . . 2 . 
. 8 . . . . . . 2 . . . . . . . . . . . . . . . g g . . . . 2 . 
f 8 . . . . . . 2 . . . . . . . . . . . . . . . g g g . . . 2 . 
. 8 . . . . . . 2 . . . . . . . . . . 4 . 1 . 4 . 1 g 2 . . 2 . 
f 8 . . . . . . 2 . . . . . 8 . 2 . . . . . . . . . . g . . 2 . 
. 8 . . . . . . 2 . . . . . 8 . 2 . . . . . . . . . . 8 g . 2 . 
f 8 . . . . . . 2 . . . . . 8 . 2 . . . . . . . . . . . . . 2 . 
. 9 1 1 . . 1 1 3 . . . . . h h h . . . . . . . . . . 2 . . 2 . 
f . . 2 . . 8 . . . . . . . . . . . . . . . . . . . . . . . 2 . 
. c 4 4 . . 4 4 6 . . . . . . . . . . . . . . . . . . 8 . . 2 . 
f 8 . . . . . . 2 . . . . . . . . . . . . . . . . . . . . . 2 . 
. 8 . . . . . . 2 1 1 1 1 1 1 1 1 1 1 1 1 1 1 1 1 1 1 1 . . 2 . 
f 8 . . . . . . . . . . . . . . . . g . g . . . . . . . . . 2 . 
. 8 . . . . . . . f . . . . . . . . . g . g . g . . g . . . 2 . 
f 8 . . . . . . . . . . . . . . . g g g g . . . . . . . . . 2 . 
. 8 . . . . . . . . . f . . . . . . . g . g . . . . . . . . 2 . 
f 8 . . . . . . . . . . . . . . . . . . . . g . . . . . . . 2 . 
. 8 i . . . . . . f . . . . . . . . . . . . . . . . . . . . 2 . 
f 8 . i . . . . . . . . . . . . . . . . . . . . . . . . . . 2 . 
. 8 . . i . . . . . . f . . . . . . . . . . . . . . . . . . 2 . 
f 8 . . . i . . . . . . . . . e . e . e . . . . . . . . . . 2 . 
. 9 1 1 1 1 1 1 1 1 1 1 1 1 1 1 1 1 1 1 1 1 1 1 1 1 1 1 1 1 3 . 
f . . . . . . . . . . . . . . . . . . . . . . . . . . . . . . . 
. P U T T P U T T . D E M O . . . . . . . . . . . J C R E E D .


