. . . . . . . . . . . . . . . . . . . . . . . . . . . . . . . .
. c 4 4 4 4 4 4 4 4 4 4 4 4 4 4 4 4 4 4 4 4 4 4 4 4 4 4 4 4 6 . 
. 8 . . . . . . . . . . . . . . . . . . . . . . . . . . . . 2 . 
. 8 . . . . . . . . 2 4 4 4 4 8 . . . . . . . . . . . . . . 2 . 
. 8 . . . . . . . . 2 . . . . 8 . . . . . . . . . . . . . . 2 . 
. 8 . . . . . . . . 2 . . . . 8 . . . . . . . . . . . . . . 2 . 
. 8 . . . . . x . . 2 . . . . 8 . . . . . . . . . . . . . . 2 . 
. 8 . . . . . . . . 2 . . . . 8 . . . . . . . . o . . . . . 2 . 
. 8 . . . . . . . . 2 . . . . 8 . . . . . . . . . . . . . . 2 . 
. 8 . . . . . . . . 2 . . . . 8 . . . . . . . . . . . . . . 2 . 
. 8 . . . . . . . . 2 . . . . 8 . . . . . . . . . . . . . . 2 . 
. 8 . . . . . . . . 2 . . . . 8 . . . . . . . . . . . . . . 2 . 
. 8 . . . . . . . . 2 . . . . 8 . . . . . . . . . . . . . . 2 . 
. 8 . . . . . . . . 2 1 1 1 1 8 . . . . . . . . . . . . . . 2 . 
. 8 . . . . . . . . . . . . . . . . . . . . . . . . . . . . 2 . 
. 8 . . . . . . . . . . . . . . . . . . . . . . . . . . . . 2 . 
. 8 . . . . . . . . . . g . g . . . . . . . . . . . . . . . 2 . 
. 8 . . . . . . . . . . . g . g . . . . . . . . . . . . . . 2 . 
. 8 . . . . . . . . . . g g g . . . . . . . . . . . . . . . 2 . 
. 8 . . . . . . . . . . . g . . . g . . . . . . . . . . . . 2 . 
. 8 . . . . . . . . . . . . . . . . . . . . . . . . . . . . 2 . 
. 8 . . . . . . . . 1 1 1 1 1 1 . . . . . . . . . . . . . . 2 . 
. 8 . . . . . . . . 2 . . . . 8 . . . . . . . . . . . . . . 2 . 
. 8 . . . . . . . . 2 . . . . 8 . . . . . . . . . . . . . . 2 . 
. 9 1 1 1 1 1 1 1 1 3 . . . . 9 1 1 1 1 1 1 1 1 1 1 1 1 1 1 3 . 
. . . . . . . . . . . . . . . . . . . . . . . . . . . . . . . .
. . . . . . . . . . . . . . . . . . . . . . . . . . . . . . . .
. . . . . . . . . . . . . . . . . . . . . . . . . . . . . . . .