. . . . . . . . . . . . . . . . . . . . . . . . . . . . . . . .
. c 4 4 4 4 4 4 4 4 6 . . . . c 4 4 4 4 4 4 4 4 4 4 4 4 4 4 6 . 
. 8 . . . . . . . . 2 . . . . 8 . . . . . . . . . . . . . . 2 . 
. 8 . . . . . . . . 2 . . . . 8 . . . . . . . . . . . . . . 2 . 
. 8 . . . . . . . . 2 . . . . 8 . . . . . . . . . . . . . . 2 . 
. 8 . . . . . . . . 2 . . . . 8 . . . . . . . . . . . . . . 2 . 
. 8 . . . . . x . . 2 . . . . 8 . . . . . . . . . . . . . . 2 . 
. 8 . . . . . . . . 2 . . . . 8 . . . . . . . . o . . . . . 2 . 
. 8 . . . . . . . . 2 . . . . 8 . . . . . . . . . . . . . . 2 . 
. 8 . . . . . . . . 2 . . . . 8 . . . . . . . . . . . . . . 2 . 
. 8 . . . . . . . . 2 . . . . 8 . . . . . . . . . . . . . . 2 . 
. 8 . . . . . . . . 2 . . . . 8 . . . . . . . . . . . . . . 2 . 
. 8 . . . . . . . . 2 . . . . 8 . . . . . . . . . . . . . . 2 . 
. 8 . . . . . . . . 2 1 1 1 1 1 . . . . . . . . . . . . . . 2 . 
. 8 . . . . . . . . . . . . . . . . . . . . . . . . . . . . 2 . 
. 8 . . . . . . . . . . . . . . . . . . . . . . . . . . . . 2 . 
. 8 . . . . . . . . . . g . g . . . . . . . . . . . . . . . 2 . 
. 8 . . . . . . . . . . . g . g . . . . . . . . . . . . . . 2 . 
. 8 . . . . . . . . . . g g g . . . . . . . . . . . . . . . 2 . 
. 8 . . . . . . . . . . . g . . . g . . . . . . . . . . . . 2 . 
. 8 . . . . . . . . . . . . . . . . . . . . . . . . . . . . 2 . 
. 8 . . . . . . . . . . . . . . . . . . . . . . . . . . . . 2 . 
. 8 . . . . . . . . . . . . . . . . . . . . . . . . . . . . 2 . 
. 8 . . . . . . . . . . . . . . . . . . . . . . . . . . . . 2 . 
. 9 1 1 1 1 1 1 1 1 1 1 1 1 1 1 1 1 1 1 1 1 1 1 1 1 1 1 1 1 3 . 
. . . . . . . . . . . . . . . . . . . . . . . . . . . . . . . .
. . . . . . . . . . . . . . . . . . . . . . . . . . . . . . . .
. . . . . . . . . . . . . . . . . . . . . . . . . . . . . . . .