. . . . . . . . . . . . . . . . . . . . . . . . . . . . . . . .
. c 4 4 4 4 4 4 4 4 4 4 4 4 4 4 4 4 4 4 4 4 4 4 4 4 4 4 4 4 6 . 
. 8 . . . . . . . . . . . . . . . . . . . . . . . . . . . . 2 . 
. 8 . . . . . . . . . . . . . . . . . . . . . . . . . . . . 2 . 
. 8 . . . . . . . . . . . . . . . . . . . . . . . . . . . . 2 . 
. 8 . . . . . . . . . . . . . . . . . . . . . . . . . . . . 2 . 
. 8 . . . . . . . . . . . . . . . . . . . . . . . . . . . . 2 . 
. 8 . . . . . . . . . . . . . . . . . . . . . . . . . . . . 2 . 
. 8 . . . . . . . . . . . . . . . . . . . . . . . . . . . . 2 . 
. 8 . . . . . . . . . . . . . . . . . . . . . . . . . . . . 2 . 
. 8 . . . . . . . . . . . . . . . . . . . . . . . . . . . . 2 . 
. 8 . . . . . . . . . . . . . . g . . . . . . . . . . . . . 2 . 
. 8 . . . . . . . . . . . . . . . . . g . . . . . . . . . . 2 . 
. 8 . . . . . . . . . . . . . . . g . . . . . . . . . . . . 2 . 
. 8 . . . . . . . . . . . . . g g 4 4 4 4 4 4 4 4 4 . . . . 2 . 
. 8 . . . . . . . . . . . . . . g g . . . . . . . . . . . . 2 . 
. 8 . . . . . . . . . . . . g g g . . . . . . . . . . . . . 2 . 
. 8 . . . . . . . . . . . . . . . . . g . . . . . . . . . . 2 . 
. 8 . . . . . . . . . . . g . . g . . . . . . . . . . . . . 2 . 
. 8 . . . . . . . . . . . . . . . . . . . . . . . . . . . . 2 . 
. 8 . . . . . . . . . . . . . . . . . . . . . . . . . . . . 2 . 
. 8 . . . . . . . . . . . . . . . . . . . . . . . . . . . . 2 . 
. 8 . . . . . . . . . . . . . . . . . . . . . . . . . . . . 2 . 
. 8 . . . . . . . . . . . . . . . . . . . . . . . . . . . . 2 . 
. 9 1 1 1 1 1 1 1 1 1 1 1 1 1 1 1 1 1 1 1 1 1 1 1 1 1 1 1 1 3 . 
. . . . . . . . . . . . . . . . . . . . . . . . . . . . . . . .
. . . . . . . . . . . . . . . . . . . . . . . . . . . . . . . .
. . . . . . . . . . . . . . . . . . . . . . . . . . . . . . . .



