. . . . . . . . . . . . . . . . . . . . . . . . . . . . . . . .
. c 4 4 4 4 4 4 4 4 4 4 4 4 4 4 4 4 4 4 4 4 4 4 4 4 4 4 4 4 6 . 
. 8 . . . . . . . . . . . . o . . . . g . . . . . . . . . . 2 . 
. 8 . . . . . . . . 2 4 4 4 4 8 . . g . . . . . . . . . . . 2 . 
. 8 . . . . 1 . 1 . 2 x . . . 8 . g . . . . . . . . . . . . 2 . 
. 8 . . . . . . . . 2 . . . . 8 g . . . . . . . . . . . . . 2 . 
. 8 . . . . . . . . 2 . . . . 8 . . . . . . . . . . . . . . 2 . 
. 8 . . . . . . . . 2 . . . . 8 . . . . . . . . . . . . . . 2 . 
. 8 . . . . . . . g . . . . . . g . . . . . . . . . . . . . 2 . 
. 8 . . . . . . . . 2 . . . . 8 . . . . . . . . . . . . . . 2 . 
. 8 . . . . . . . . 2 . . 1 . 8 . . . . . . . . . . . . . . 2 . 
. 8 . . . . . . . . 2 . . . . 8 . . . . . . . . . . . . . . 2 . 
. 8 . . . . . . . . 2 . . f . 8 . . . . . . . . . . . . . . 2 . 
. 8 . . . . . . . . 2 1 1 . 1 8 . . . . . . . . . . . . . . 2 . 
. 8 . . . . . . . . . . . . . . . . . . . . . . . . . . . . 2 . 
. 8 . . . . . . . . . . . . . . . . . . . . . . . . . . . . 2 . 
. 8 . . . . . . . . . . g . g . . . . . . . . . . . . . . . 2 . 
. 8 . . . . . . . . . . . g . g . . . . . . . . . . . . . . 2 . 
. 8 . . . . . . . . . . g g g . . . . . . . . . . . . . . . 2 . 
. 8 . . . . . . . . . . . g . . . g . . . . . . . . . . . . 2 . 
. 8 . . . . . . . . . . . . . . . . . . . . . . . . . . . . 2 . 
. 8 . . . . . . . . 1 1 1 1 1 1 . . . . . . . . . . . . . . 2 . 
. 8 . . . . . . . . 2 . . . . 8 . . . . . . . . . . . . . . 2 . 
. 8 . . . . . . . . 2 . . . . 8 . . . . . . . . . . . . . . 2 . 
. 9 1 1 1 1 1 1 1 1 3 . . . . 9 1 1 1 1 1 1 1 1 1 1 1 1 1 1 3 . 
. . . . . . . . . . . . . . . . . . . . . . . . . . . . . . . .
. . . . . . . . . . . . . . . . . . . . . . . . . . . . . . . .
. . . . . . . . . . . . . . . . . . . . . . . . . . . . . . . .